11111111-
15555551-
11111151-
15555551-
15111111-
15555551-
11111151-
15555551-
15111111-
15555551-
11111111-
11111111

